Вбудовані функції (Built in Functions)

abs() — Повертає абсолютне значення числа

all() — Повертає True, якщо всі елементи в ітерованому об'єкті є істинними

any() — Повертає True, якщо будь-який елемент в ітерованому об'єкті є істинним

ascii() — Повертає читабельну версію об'єкта. Замінює не-ascii символи на символ екранування

bin() — Повертає бінарну версію числа

bool() — Повертає булеве значення заданого об'єкта

bytearray() — Повертає масив байтів

bytes() — Повертає об'єкт у вигляді байтів

callable() — Повертає True, якщо вказаний об'єкт може бути викликаний, інакше False

chr() — Повертає символ із заданого коду Unicode.

classmethod() — Перетворює метод в метод класу

compile() — Повертає вказане джерело як об'єкт, готовий до виконання

complex() — Повертає комплексне число

delattr() — Видаляє вказаний атрибут (властивість або метод) із вказаного об'єкта

dict() — Повертає словник (масив)

dir() — Повертає список властивостей та методів вказаного об'єкта

divmod() — Повертає частку та остачу від ділення аргументу1 на аргумент2

enumerate() — Отримує колекцію (наприклад, кортеж) і повертає її як об'єкт у вигляді переліку

eval() — Обчислює та виконує вираз

exec() — Виконує вказаний код (або об'єкт)

filter() — Використовує функцію фільтрації, щоб виключити елементи в ітерованому об'єкті

float() — Повертає число з плаваючою комою

format() — Форматує задане значення

frozenset() — Повертає об'єкт frozenset (який схожий на об'єкт множини, тільки незмінний).

getattr() — Повертає значення вказаного атрибуту (властивості або методу)

globals() — Повертає поточну глобальну таблицю символів у вигляді словника

hasattr() — Повертає True, якщо вказаний об'єкт має вказаний атрибут (властивість/метод)

hash() — Повертає хеш-значення заданого об'єкта

help() — Запускає вбудовану довідкову систему

hex() — Перетворює число в шістнадцяткове значення

id() — Повертає ідентифікатор об'єкта

input() — Дозволяє користувачеві вводити дані

int() — Повертає ціле число

isinstance() — Повертає True, якщо заданий об'єкт є екземпляром заданого об'єкта

issubclass() — Повертає True, якщо заданий клас є підкласом заданого об'єкта

iter() — Повертає об'єкт ітератора

len() — Повертає довжину об'єкта

list() — Повертає список

locals() — Повертає оновлений словник поточної локальної таблиці символів

map() — Повертає вказаний ітератор з вказаною функцією, застосованою до кожного елемента

max() — Повертає найбільший елемент в ітерованому списку

memoryview() — Повертає об'єкт перегляду пам'яті

min() — Повертає найменший елемент в ітерованому списку

next() — Повертає наступний елемент в ітерованому списку

object() — Повертає новий об'єкт

oct() — Перетворює число у вісімкову систему числення

open() — Відкриває файл і повертає файловий об'єкт

ord() — Конвертує ціле число, що представляє Unicode вказаного символу

pow() — Повертає значення «x» в степені «y«

print() — Друк на стандартний пристрій виведення

property() — Отримує, встановлює та видаляє властивість

range() — Повертає послідовність чисел, починаючи з 0 і збільшується на 1 (за замовчуванням)

repr() — Повертає читабельну версію об'єкта

reversed() — Повертає обернений ітератор

round() — Округлює числа

set() — Повертає новий об'єкт множини

setattr() — Встановлює атрибут (властивість/метод) об'єкта

slice() — Повертає об'єкт зрізу

sorted() — Повертає відсортований список

staticmethod() — Перетворює метод у статичний метод

str() — Повертає об'єкт типу string

sum() — Підсумовує елементи ітератора

super() — Повертає об'єкт, що представляє батьківський клас

tuple() — Повертає кортеж

type() — Повертає тип об'єкта

vars() — Повертає властивість __dict__ об'єкта

zip() — Повертає об'єкт zip, який є ітератором кортежів, де перший елемент у кожному переданому 
ітераторі з'єднаний разом, потім другий елемент у кожному переданому ітераторі з'єднаний разом і т.д.
