Python. Рядкові методи (String methods)

Усі рядкові методи повертають нові значення. Вони не змінюють вихідний рядок.

capitalize() — Перетворює перший символ у верхній регістр

casefold() — Перетворює рядок у нижній регістр

center() — Повертає відцентрований рядок

count() — Повертає кількість входжень заданого значення у рядку

encode() — Повертає закодовану версію рядка

endswith() — Повертає true, якщо рядок закінчується заданим значенням

expandtabs() — Встановлює розмір табуляції рядка

find() — Шукає в рядку задане значення і повертає розташування, де його було знайдено

format() — Форматує задані значення в рядок

format_map() — Форматує задані значення в рядок

index() — Шукає в рядку задане значення і повертає розташування, де його було знайдено

isalnum() — Повертає True, якщо всі символи в рядку є буквенно-цифровими

isalpha() — Повертає True, якщо всі символи в рядку містять літери

isascii() — Повертає True, якщо всі символи в рядку є символами ASCII

isdecimal() — Повертає True, якщо всі символи в рядку є десятичним и числами

isdigit() — Повертає True, якщо всі символи в рядку є цифрами

isidentifier() — Повертає True, якщо рядок є ідентифікатором

islower() — Повертає True, якщо всі символи в рядку нижнього регістру

isnumeric() — Повертає True, якщо всі символи в рядку є числовими

isprintable() — Повертає True, якщо всі символи в рядку можна виводити на друк

isspace() — Повертає True, якщо всі символи в рядку є пробілами

istitle() — Повертає True, якщо рядок слідує правилам заголовка

isupper() — Повертає True, якщо всі символи в рядку у верхньому регістрі

join() — Конвертує елементи ітерованого списку в рядок

ljust() — Повертає виправлену з самого початку версію рядка

lower() — Перетворює рядок у нижній регістр

lstrip() — Повертає версію рядка, де видалені всі початкові символи (пробіл є початковим символом за замовчуванням).

maketrans() — Повертає таблицю відповідників для використання у перекладах

partition() — Повертає кортеж, в якому рядок розділено на три частини

replace() — Шукає в рядку задане значення і повертає останнє місце, де його було знайдено

rfind() — Шукає в рядку останнє входження вказаного значення, і повертає місце розташування

rindex() — Шукає в рядку останнє входження вказаного значення і повертає місце розташування

rjust() — Повертає правильний виправлений варіант рядка

rpartition() — Повертає кортеж, в якому рядок розділено на три частини

rsplit() — Розділяє рядок за вказаним роздільником і повертає список

rstrip() — Повертає версію рядка, де видалені всі кінцеві символи (символи в кінці рядка), пробіл є типовим символом для видалення

split() — Розділяє рядок за вказаним роздільником і повертає список

splitlines() — Розбиває рядок на список. Розділення відбувається на переходах рядка.

startswith() — Повертає True, якщо рядок починається з вказаного значення

strip() - Повертає версію рядка без початкових та кінцевих пробілів

swapcase() — Міняє регістри, нижній регістр стає верхнім і навпаки

title()Перетворює перший символ кожного слова у верхній регістр

translate() — Повертає перекладений рядок

upper() — Перетворює вміст рядку на верхній регістр

zfill() — Додає нулі (0) на початку рядка, поки він не досягне заданої довжини.
